1111111111
10000P0001
100C0000E1
1111111111