111111111
100P00C01
10C000Y01
10Y000C01
10C0Y0001
100000E01
111111111