1111111111111111
1P0001Y000000001
100Y01YE00100001
1000Y10000Y10001
1Y0001000Y010001
1Y0000000001C001
1111111111111111