1111111111
1001C10001
10010100E1
1P00000001
1111111111