1111111111111111
1P0001Y000000001
100Y01Y000100001
1000Y1000Y010001
1Y00010000Y10001
1Y0000000001C0E1
1111111111111111