111111111
1000C0001
100CPC001
1000C00E1
111111111
