1111111
1P00001
1Y0C001
10000E1
1111111