111111111111
1CP0000010E1
111111111111