111111111111
100000000011
1CP0000000E1
100000000011
111111111111