1111111
1C1P1E1
1000001
1010011
1C100C1
1111111