1111111
1C1PE01
1000001
1110011
1C101C1
1111111