111111111
100C0C001
10C0E0C01
100C0C0P1
111111111