11111111111111111
1000000C0C0C000C1
100C0000000000001
10000P000C0C00001
100000000000000E1
11111111111111111