11111111111
100P0000001
1C0C0C0C001
100000000E1
11111111111