11111111111111
1E110111000001
10110111111101
10000001P00CC1
11110111011111
11110111000001
11111111111111