1111111
1C1PE11
1111111
1111111
1111111
1111111