11111111111
100P0000001
1C0C0C0C001
1000000Y0E1
11111111111